1 2 2975 3646 
1 4 2058 924 3761 1201 
1 5 1201 1748 3749 922 3760 
1 5 3760 3754 1893 2367 2986 
1 6 3760 3766 338 1373 1601 1116 
1 5 2986 1284 3 2076 3646 
1 10 2986 204 2487 338 3772 638 693 3301 1205 445 
1 7 445 1989 1381 1744 485 3656 2975 
1 7 2058 1396 2411 1955 3658 2397 3634 
1 4 3634 3390 1122 3605 
1 3 3605 3597 3585 
1 2 3585 1942 
1 5 3605 1956 3592 1494 3580 
1 4 3580 3125 1643 1557 
1 8 3226 308 2902 1519 288 713 1548 1461 
